sorga - agros
saf - fas
te - et
rób - bór
pał - łap
ład - dał
raki - ikar
afro - orfa
ran - nar
drak - kard
flor - rolf
sok - kos
gaj - jag
każ - żak
melexa - axelem
agar - raga
bul - lub
ruf - fur
omar - ramo
łów - wół
łaps - spał
ognik - kingo
łub - buł
atom - mota
mil - lim
ale - ela
rud - dur
mik - kim
aktom - motka
gol - log
sram - mars
jat - taj
druk - kurd
łuku - ukuł
sol - los
por - rop
luk - kul
ablem - melba
latem - metal
and - dna
kort - trok
mart - tram
aktem - metka
kalam - malak
mus - sum
mor - rom
brak - karb
sar - ras
monar - ranom
ind - dni
blok - kolb
not - ton
ulec - celu
gros - sorg
kra - ark
kor - rok
mada - adam
ogol - logo
min - nim
rej - jer
rot - tor
atak - kata
mej - jem
dima - amid
loko - okol
lu - ul
truj - jurt
zip - piz
krab - bark
sap - pas
ona - ano
daj - jad
lag - gal
mesa - asem
ram - mar
trap - part
odom - modo
milik - kilim
moda - adom
imam - mami
pot - top
pud - dup
eli - ile
gnat - tang
oni - ino
smar - rams
kuł - łuk
lem - mel
leon - noel
net - ten
aneta - atena
leż - żel
tur - rut
kod - dok
gard - drag
pik - kip
fos - sof
sab - bas
las - sal
udar - radu
włóż - żółw
pak - kap
alim - mila
ola - alo
trep - pert
win - niw
elba - able
ogon - nogo
imć - ćmi
kebab - babek
noska - akson
okryw - wyrko
rac - car
pęk - kęp
zakop - pokaz
ryż - żyr
juk - kuj
aktu - utka
to - ot
arka - akra
kąp - pąk
skok - koks
tul - lut
owe - ewo
obal - labo
run - nur
ket - tek
pysz - zsyp
luks - skul
drab - bard
sil - lis
okna - anko
dal - lad
wal - law
otok - koto
rat - tar
lamo - omal
par - rap
ren - ner
wór - rów
amar - rama
mamo - omam
wab - baw
dar - rad
belg - gleb
potu - utop
wał - ław
kot - tok
elu - ule
okaż - żako
mat - tam
der - red
tez - zet
udaj - jadu
buk - kub
żartem - metraż
soku - ukos
werk - krew
nil - lin
żaku - ukaż
tak - kat
ładu - udał
dnem - mend
kara - arak
pył - łyp
uskok - koksu
ikra - arki
sopot - topos
aren - nera
mer - rem
igor - rogi
nap - pan
kit - tik
kinu - unik
srok - kors
ranek - kenar
rep - per
kark - krak
zeus - suez
bej - jeb
aten - neta
tuta - atut
tub - but
trak - kart
rag - gar
lip - pil
ado - oda
tal - lat
sak - kas
maj - jam
lemat - tamel
ula - alu
raf - far
kabat - tabak
wer - rew
traw - wart
lec - cel
tran - nart
kar - rak
mi - im
was - saw
lik - kil
kapo - opak
he - eh
ful - luf
pool - loop
mur - rum
typ - pyt
ski - iks
atlas - salta
katom - motak
do - od
ina - ani
ej - je
barok - korab
mens - snem
iluż - żuli
lig - gil
gór - róg
dam - mad
sur - rus
goj - jog
kinom - monik
lot - tol
cup - puc
port - trop
jut - tuj
cip - pic
rab - bar
ole - elo
srom - mors
miks - skim
atenom - moneta
małym - myłam
agon - noga
abla - alba
lab - bal
nilem - melin
ranie - einar
sam - mas
traf - fart
mag - gam
bet - teb
koma - amok
tka - akt
wyż - żyw
raj - jar
er - re
cap - pac
brok - korb
nit - tin
nok - kon
mak - kam
ilu - uli
kęs - sęk
ikara - araki
targ - grat
kin - nik
ogni - ingo
diw - wid
on - no
